=======================================
====*****==============================
====*****==============================
====*****==============**************==
====*****====***=======**************==
====*****====***=======================
=============***========******=========
=============***========******=========
========================******=========
=======================================
